4,5,5,7,3,6,3,4,5,1,2,2,2,2
2,4,5,9,10,10,14,5,7,5,9,10,10,10
14,5,7,1,10,8,14,3,12,7,5,9,14,11
14,3,10,2,12,5,11,12,5,15,5,5,9,10
10,12,13,13,7,3,12,5,3,12,7,7,7,11
10,6,7,3,10,14,5,3,14,5,11,10,8,10
10,10,10,12,11,10,6,11,10,2,10,12,7,10
10,10,12,5,11,10,12,9,10,10,12,1,10,10
10,14,5,5,9,14,5,5,9,12,5,5,9,8
12,13,3,4,7,13,3,2,2,6,1,2,2,2
6,5,15,7,15,1,14,15,11,10,6,9,10,10
10,6,9,8,10,4,11,8,10,10,14,5,11,10
10,12,5,3,14,5,15,7,11,14,11,4,9,10
12,5,1,8,8,0,8,8,12,9,12,5,5,9
